111111111111111111
100000C00000001001
10C00000000C001001
1C00000E000P001001
100000000000000001
111111111111111111
