111111111111111111
100000C00000001001
10C00000000C001001
100000E0000P001001
1000000000000010C1
111111111111111111
