111111111111111111
100001C00100000001
10C00111100C000001
100000E0000P000001
1000000000000000C1
111111111111111111
