111111111111111111
100000C00000001001
10C00000000C001001
1000000E000P001001
1000000000000000C1
111111111111111111
