111111111111111111
100000000000000001
10C0000C0000C00001
100000E0000P000001
1000000000000000C1
111111111111111111
