111111111111111111
1C00000000010010C1
10000C0000101000E1
1000000000P01010C1
10000C000000001001
111111111111111111
