111111111111111111
10C000000000000001
1000000C0000000001
10000000000P000001
10C0000000000000C1
111111111111111111
