111111111111111111
1CCCCCCCCCCCCCCCC1
1CCCCCCCECCCCCCCC1
1CCCCCCCCCCCCCCCC1
1CCCCPCCCCCCCCCCC1
1CCCCCCCCCCCCCCCC1
1CCCCCCCCCCCCCCCC1
111111111111111111
