111111111111111111
100000C00000000001
10C00000000C000001
100000E0000P000001
1000000000000000C1
111111111111111111
