
111111111111111111111111111
100000010100000000000000001
100000001000000000000000001
100000000111000000000000001
100000000000100000000000001
100000000000010000000000001
10000000P000001100000000001
1000000000000001C1000000001
100000000000000010000000001
100000000000000001000000001
100000C00000000000100000001
100000000C00000000010000001
100000000000000000000001111
100000000000000001E10000001
100000000001010000100000001
10000000000000000C000000001
100000000000000000000000001
100000000000000000000000001
100000000000000000000000001
111111111111111111111111111
