
111111111111111111111111111
100000010100000000000000001
100000001000000000000000001
100000000000000000000000001
100000000000C00000000000001
100000000000000000000000001
10000000P000000110000000001
1000C00000000001C1000000001
100000000000000010000000001
100000000000000000000000001
100000000000000000000000001
100000000000000000000000001
100000000000000000000000001
100000000000000000000000001
100000000001C10000000000001
100000000000000000000000001
100000000000000000000000001
100000000000000000000000001
100000000000000000000000001
111111111111111111111111111
