1111111111111111111111
1000000000000000000001
1000000000000000000001
1000000000000000000001
100000000000C000000001
1000000000000000000001
10000000P0000000000001
1000000000000000C00001
1000000000000000000001
1000000000000000000001
1000000000000000000001
1000E00000000000000001
1000000000000000000001
1000000000011100000001
100000000001C100000001
1000000000011100000001
1000000000000000000001
1000000000000000000001
1000000000000000000001
1111111111111111111111