1111111000111111111111
1000000101000000000001
1000000010000000000001
1000000000000000000001
100000000000C000000001
1000000000000000000001
10000000P0000000000001
1000C00000000000C00001
1000000000000000000001
1000000000000000000001
1000000000000000000001
1000E00000000000000001
1000000000000000000001
1000000000001000000001
100000000001C100000001
1000000000000000000001
1000000000000000000001
1000000000000000000001
1000000000000000000001
1111111111111111111111