1111111
1111C11
11P0E11
1111111