1111111
1ECCCC1
1CCPCC1
1111111