1111111
1****11
1***1C1
1111111