11111111111111111111
1000P0000000C0000001
10000000100000000001
10E00000100000000001
11111111111111111111